CarCount,BikeCount,BusCount,TruckCount,Total,Traffic Situation
31,0,4,4,39,low
49,0,3,3,55,low
46,0,3,6,55,low
51,0,2,5,58,low
57,6,15,16,94,normal
44,0,5,4,53,low
37,0,1,4,42,low
42,4,4,5,55,low
51,0,9,7,67,low
34,0,4,7,45,low
45,0,1,1,47,low
45,0,1,3,49,low
50,0,3,0,53,low
34,0,4,4,42,low
129,22,42,1,194,heavy
144,16,49,0,209,heavy
111,28,20,3,162,normal
67,11,10,16,104,normal
65,24,7,16,112,normal
94,27,7,16,144,normal
94,20,8,7,129,normal
67,29,5,10,111,low
56,12,2,14,84,normal
57,13,3,11,84,low
129,22,42,1,194,heavy
144,16,49,0,209,heavy
111,28,20,3,162,normal
120,27,46,3,196,heavy
102,39,47,1,189,heavy
145,23,27,0,195,heavy
114,37,21,5,177,heavy
108,18,22,1,149,normal
122,28,33,1,184,heavy
114,39,30,3,186,heavy
150,36,25,1,212,heavy
107,10,49,2,168,heavy
124,24,22,0,170,heavy
77,16,39,29,161,high
15,23,30,21,89,normal
32,22,38,21,113,high
68,13,29,24,134,high
27,16,36,30,109,normal
76,7,11,15,109,normal
41,23,20,17,101,normal
33,10,3,29,75,normal
58,8,14,29,109,normal
65,7,11,26,109,normal
47,9,6,29,91,normal
38,10,5,25,78,normal
57,8,12,29,106,normal
20,6,4,20,50,normal
24,9,14,23,70,normal
52,10,13,21,96,normal
79,15,36,18,148,high
84,24,22,18,148,normal
59,19,35,16,129,high
88,26,31,19,164,high
24,11,32,13,80,normal
110,17,23,20,170,heavy
29,26,5,6,66,low
43,26,11,20,100,normal
68,28,9,15,120,normal
108,16,8,18,150,normal
101,26,8,14,149,normal
141,31,36,6,214,heavy
120,25,28,5,178,heavy
137,23,44,5,209,heavy
124,11,30,7,172,heavy
145,25,49,7,226,heavy
122,37,23,8,190,heavy
136,30,20,9,195,heavy
145,18,40,9,212,heavy
138,34,28,5,205,heavy
123,10,29,8,170,heavy
105,15,21,9,150,normal
75,22,20,11,128,normal
90,12,10,13,125,normal
102,22,20,16,160,normal
61,18,15,27,121,high
70,8,14,6,98,low
80,17,12,34,143,high
62,12,14,19,107,normal
96,5,11,13,125,normal
102,6,12,13,133,normal
91,14,15,6,126,normal
95,8,17,13,133,normal
75,15,12,21,123,high
53,21,20,10,104,normal
13,1,0,19,33,normal
10,0,1,24,35,normal
16,2,0,33,51,normal
11,1,0,29,41,normal
18,2,1,13,34,normal
15,0,1,11,27,low
14,1,0,33,48,normal
17,2,0,22,41,normal
12,2,1,17,32,normal
18,0,0,29,47,normal
16,1,0,14,31,normal
20,0,0,14,34,normal
20,1,1,30,52,normal
15,0,1,23,39,normal
16,0,1,26,43,normal
18,4,0,11,33,low
17,3,1,36,57,normal
14,4,1,10,29,low
18,2,1,25,46,normal
12,2,0,19,33,normal
11,4,0,30,45,normal
19,1,1,36,57,normal
10,4,0,36,50,normal
20,1,1,32,54,normal
15,5,1,40,61,normal
104,6,5,1,116,normal
109,25,3,8,145,normal
82,23,8,20,133,normal
81,25,1,18,125,normal
95,16,10,1,122,normal
91,24,7,6,128,normal
81,30,10,0,121,normal
125,13,26,2,166,high
125,39,49,3,216,heavy
125,34,37,1,197,heavy
125,19,25,4,173,heavy
125,15,49,0,189,heavy
125,32,50,5,212,heavy
125,38,50,1,214,heavy
125,29,29,3,186,heavy
125,31,48,4,208,heavy
125,32,50,0,207,heavy
125,31,45,0,201,heavy
125,21,20,1,167,normal
125,28,36,0,189,heavy
39,10,37,16,102,normal
89,8,12,13,122,normal
51,16,16,13,96,normal
17,9,18,28,72,normal
48,25,36,21,130,high
93,7,30,16,146,high
55,15,36,15,121,high
51,10,8,22,91,normal
51,7,3,24,85,normal
51,9,7,30,97,normal
51,7,14,20,92,normal
51,10,14,20,95,normal
51,10,6,22,89,normal
51,8,11,22,92,normal
51,6,10,26,93,normal
51,7,7,27,92,normal
104,17,25,20,166,normal
6,28,27,14,75,normal
54,29,37,9,129,high
43,13,30,20,106,normal
60,21,26,11,118,high
101,23,8,20,152,normal
62,26,19,11,118,normal
39,24,13,11,87,low
90,20,35,7,152,high
109,30,22,20,181,heavy
68,26,25,20,139,normal
142,22,37,6,207,heavy
113,14,20,5,152,normal
142,13,37,8,200,heavy
108,23,26,9,166,high
122,29,30,7,188,heavy
133,12,30,7,182,heavy
118,23,38,10,189,heavy
121,35,26,8,190,heavy
116,23,20,8,167,normal
132,12,27,8,179,heavy
144,17,33,7,201,heavy
103,21,11,11,146,normal
107,15,10,15,147,normal
50,10,10,17,87,normal
108,15,10,6,139,normal
108,24,15,29,176,heavy
101,6,15,13,135,normal
55,17,12,19,103,normal
77,7,20,16,120,normal
91,12,19,8,130,normal
95,25,17,29,166,high
78,17,17,27,139,high
98,16,16,21,151,high
86,13,11,35,145,high
18,4,0,16,38,normal
18,5,0,12,35,low
18,2,1,25,46,normal
18,1,0,17,36,normal
18,5,0,21,44,normal
18,0,1,12,31,low
18,3,1,28,50,normal
18,4,1,40,63,normal
18,1,1,39,59,normal
18,4,0,30,52,normal
18,5,1,13,37,normal
18,2,0,37,57,normal
18,0,0,13,31,normal
18,5,0,11,34,low
18,5,1,12,36,low
18,1,1,16,36,normal
18,1,1,34,54,normal
18,1,0,24,43,normal
18,0,0,23,41,normal
18,0,0,27,45,normal
18,5,0,28,51,normal
18,1,0,14,33,normal
18,5,0,25,48,normal
18,4,1,30,53,normal
18,5,1,30,54,normal
62,24,7,2,95,low
51,23,6,1,81,low
114,23,10,19,166,normal
85,22,9,9,125,normal
102,24,4,20,150,normal
101,18,3,17,139,normal
116,19,0,17,152,normal
117,38,50,5,210,heavy
114,32,34,2,182,heavy
120,17,23,1,161,normal
145,20,25,2,192,heavy
125,30,48,1,204,heavy
103,27,45,1,176,heavy
114,20,43,1,178,heavy
145,10,44,1,200,heavy
147,31,20,4,202,heavy
104,24,40,0,168,heavy
124,11,22,0,157,normal
101,37,31,4,173,heavy
144,30,37,1,212,heavy
24,18,37,18,97,normal
24,8,17,25,74,normal
16,22,12,20,70,normal
26,2,39,26,93,normal
90,7,18,15,130,normal
59,6,11,11,87,low
28,7,22,18,75,normal
60,5,14,21,100,normal
69,9,8,23,109,normal
59,9,12,26,106,normal
24,10,5,21,60,normal
41,7,7,21,76,normal
48,10,9,29,96,normal
59,10,14,23,106,normal
67,7,12,28,114,high
52,9,8,20,89,normal
45,26,29,10,110,normal
14,21,7,18,60,normal
55,22,24,10,111,normal
45,14,39,5,103,normal
90,17,16,11,134,normal
33,21,25,5,84,normal
118,25,31,13,187,heavy
86,28,13,5,132,normal
105,29,22,12,168,heavy
10,19,26,8,63,normal
46,22,18,9,95,normal
105,35,48,6,194,heavy
135,37,34,5,211,heavy
103,29,44,6,182,heavy
113,13,42,10,178,heavy
103,20,27,9,159,high
150,13,20,9,192,heavy
116,25,33,8,182,heavy
109,16,41,9,175,heavy
112,11,50,5,178,heavy
104,31,30,5,170,heavy
146,18,40,6,210,heavy
110,24,10,29,173,heavy
60,15,12,25,112,high
103,9,14,29,155,high
102,6,15,6,129,normal
51,17,16,8,92,normal
62,12,11,18,103,normal
103,14,12,5,134,normal
50,7,11,23,91,normal
80,14,20,6,120,normal
98,13,18,21,150,high
53,25,20,13,111,normal
52,8,10,27,97,normal
71,23,13,21,128,high
17,3,0,29,49,normal
20,5,1,36,62,normal
15,0,0,32,47,normal
15,0,1,20,36,normal
14,2,0,23,39,normal
13,1,0,29,43,normal
14,5,0,31,50,normal
16,3,0,33,52,normal
18,4,1,15,38,normal
20,0,1,23,44,normal
19,3,0,16,38,normal
10,3,0,12,25,low
10,4,0,23,37,normal
12,5,0,29,46,normal
10,0,0,39,49,normal
16,2,1,21,40,normal
18,4,1,36,59,normal
15,1,0,14,30,normal
17,4,0,13,34,normal
18,3,1,24,46,normal
19,2,0,11,32,low
19,3,0,21,43,normal
19,3,1,31,54,normal
14,2,1,19,36,normal
11,0,0,27,38,normal
27,6,1,11,45,low
33,11,6,13,63,normal
63,6,7,10,86,low
58,13,4,15,90,normal
57,11,7,10,85,low
63,10,6,12,91,low
74,9,0,15,98,normal
71,9,7,10,97,low
33,9,6,13,61,normal
29,6,1,12,48,low
32,9,3,11,55,low
57,14,3,11,85,low
31,11,0,14,56,normal
30,9,3,10,52,low
61,8,7,12,88,low
47,10,4,10,71,low
80,16,4,15,115,normal
49,10,2,10,71,low
58,7,5,13,83,normal
53,19,1,10,83,low
132,47,25,0,204,heavy
131,52,15,0,198,heavy
171,59,27,3,260,heavy
131,43,20,3,197,heavy
177,56,12,4,249,heavy
160,47,30,3,240,heavy
178,68,28,4,278,heavy
169,70,20,3,262,heavy
133,56,25,2,216,heavy
151,52,13,0,216,heavy
179,46,27,3,255,heavy
144,68,20,0,232,heavy
162,46,19,2,229,heavy
159,44,23,2,228,heavy
174,67,30,1,272,heavy
136,57,29,4,226,heavy
156,42,12,3,213,heavy
175,63,19,3,260,heavy
172,62,20,2,256,heavy
171,49,15,0,235,heavy
172,65,18,2,257,heavy
176,50,13,1,240,heavy
153,50,23,3,229,heavy
148,64,27,0,239,heavy
56,28,6,2,92,low
88,26,25,0,139,normal
82,23,14,0,119,normal
77,20,7,0,104,low
66,24,1,0,91,low
72,22,8,2,104,low
62,28,21,2,113,normal
66,26,4,1,97,low
85,20,4,0,109,low
87,24,11,2,124,normal
67,28,25,0,120,normal
70,26,16,2,114,normal
62,20,20,1,103,normal
67,29,1,0,97,low
65,25,1,1,92,low
76,24,23,0,123,normal
42,1,5,11,59,low
42,10,3,1,56,low
31,11,1,12,55,low
47,7,3,6,63,low
28,7,2,4,41,low
22,3,6,1,32,low
29,1,7,5,42,low
43,9,1,11,64,low
23,3,3,8,37,low
21,2,5,15,43,normal
31,2,1,9,43,low
15,5,0,18,38,normal
11,2,0,15,28,normal
12,0,1,17,30,normal
18,3,0,18,39,normal
19,1,0,31,51,normal
17,0,0,22,39,normal
15,5,0,14,34,normal
15,1,1,24,41,normal
18,4,0,33,55,normal
14,4,0,34,52,normal
14,0,1,19,34,normal
19,3,0,36,58,normal
10,4,1,21,36,normal
19,1,0,19,39,normal
18,5,0,26,49,normal
17,1,1,25,44,normal
20,2,0,12,34,low
15,5,0,15,35,normal
11,4,0,14,29,normal
14,3,1,18,36,normal
13,2,0,39,54,normal
17,5,0,29,51,normal
13,5,0,31,49,normal
18,5,0,35,58,normal
15,4,0,16,35,normal
55,15,5,3,78,low
76,10,7,9,102,low
98,0,9,19,126,normal
98,12,6,6,122,normal
103,2,10,20,135,normal
93,17,8,12,130,normal
115,27,9,16,167,normal
120,12,22,3,157,normal
142,18,27,0,187,heavy
117,29,49,2,197,heavy
126,36,24,0,186,heavy
110,39,38,5,192,heavy
149,20,39,5,213,heavy
109,29,23,5,166,normal
124,34,24,4,186,heavy
149,35,32,1,217,heavy
125,32,38,4,199,heavy
101,23,38,1,163,high
137,36,30,0,203,heavy
139,15,21,3,178,heavy
19,3,29,9,60,normal
13,11,39,7,70,normal
31,2,29,27,89,normal
18,24,21,22,85,normal
26,12,14,13,65,normal
31,15,13,28,87,normal
12,22,8,11,53,low
54,5,13,23,95,normal
59,7,13,21,100,normal
58,8,6,23,95,normal
53,8,9,25,95,normal
54,7,7,20,88,normal
39,10,4,29,82,normal
38,9,8,22,77,normal
36,5,10,23,74,normal
68,6,12,24,110,normal
50,18,26,14,108,normal
120,28,22,20,190,heavy
60,14,28,9,111,normal
105,14,8,19,146,normal
89,27,18,8,142,normal
28,17,31,10,86,normal
79,14,23,6,122,normal
15,11,30,14,70,normal
77,27,23,18,145,normal
19,14,24,6,63,normal
79,13,28,7,127,high
114,10,22,9,155,normal
150,30,22,5,207,heavy
142,23,25,7,197,heavy
111,36,25,6,178,heavy
143,37,38,8,226,heavy
120,37,43,10,210,heavy
147,20,49,7,223,normal
140,22,27,5,194,heavy
128,37,20,9,194,heavy
114,23,42,10,189,heavy
117,20,22,9,168,heavy
93,24,17,23,157,high
65,15,15,8,103,low
100,22,14,8,144,normal
85,12,11,18,126,normal
56,7,12,12,87,low
50,12,15,18,95,normal
74,9,11,12,106,low
73,15,18,7,113,normal
99,13,20,30,162,high
110,14,17,8,149,normal
82,5,12,34,133,high
58,19,12,17,106,normal
70,10,14,32,126,high
10,1,0,33,44,normal
14,1,1,40,56,normal
17,1,1,17,36,normal
12,4,1,22,39,normal
15,0,0,16,31,normal
13,4,0,25,42,normal
14,5,1,12,32,low
18,1,1,35,55,normal
18,5,1,19,43,normal
19,3,0,38,60,normal
13,0,1,12,26,low
20,0,1,38,59,normal
20,1,1,24,46,normal
17,3,1,17,38,normal
12,3,1,35,51,normal
19,0,1,30,50,normal
19,2,1,30,52,normal
18,1,0,16,35,normal
11,0,0,31,42,normal
10,1,1,12,24,low
16,1,0,24,41,normal
18,3,0,28,49,normal
20,1,1,39,61,normal
19,3,1,27,50,normal
14,1,1,34,50,normal
61,26,1,16,104,normal
72,26,6,4,108,low
86,24,3,18,131,normal
75,1,8,10,94,low
75,1,7,9,92,low
93,5,4,1,103,low
111,6,2,5,124,normal
111,18,41,2,172,heavy
114,27,46,0,187,heavy
139,19,50,2,210,heavy
109,14,38,1,162,high
105,16,22,3,146,normal
150,13,31,4,198,heavy
122,13,47,3,185,heavy
114,24,46,2,186,heavy
119,36,41,0,196,heavy
108,35,39,0,182,heavy
113,18,28,1,160,high
118,36,37,0,191,heavy
113,35,48,3,199,heavy
66,7,22,30,125,high
64,12,27,8,111,normal
37,5,13,11,66,low
82,17,31,20,150,high
63,5,23,12,103,normal
20,12,16,24,72,normal
46,5,34,9,94,normal
35,9,8,29,81,normal
33,9,11,21,74,normal
32,9,10,30,81,normal
62,10,6,22,100,normal
62,10,11,22,105,normal
54,10,12,25,101,normal
48,8,15,23,94,normal
20,10,12,24,66,normal
35,10,5,30,80,normal
112,15,40,10,177,heavy
51,21,25,13,110,normal
53,12,23,8,96,normal
63,22,18,15,118,normal
50,23,16,8,97,normal
94,20,35,17,166,high
7,27,39,17,90,normal
109,18,13,6,146,normal
18,27,19,6,70,normal
21,30,5,5,61,low
49,16,9,12,86,low
129,28,40,6,203,heavy
141,18,28,8,195,heavy
131,14,43,7,195,heavy
105,38,23,5,171,heavy
125,35,37,5,202,heavy
127,36,42,9,214,heavy
129,22,25,9,185,heavy
121,39,47,8,215,heavy
138,29,42,9,218,heavy
119,26,21,5,171,heavy
138,17,48,8,211,heavy
72,12,14,32,130,high
92,23,20,30,165,high
94,17,11,24,146,high
102,25,12,24,163,high
71,23,17,14,125,normal
58,5,19,25,107,normal
93,22,18,10,143,normal
59,23,10,35,127,high
57,20,10,20,107,normal
96,9,18,25,148,high
104,12,16,20,152,normal
104,22,17,23,166,high
88,8,11,29,136,high
20,3,0,16,39,normal
17,2,1,30,50,normal
17,4,0,23,44,normal
15,5,0,21,41,normal
10,0,1,31,42,normal
11,1,1,19,32,normal
12,2,0,29,43,normal
11,0,1,11,23,low
18,4,1,28,51,normal
13,3,0,26,42,normal
16,3,0,34,53,normal
16,4,0,35,55,normal
20,2,1,33,56,normal
14,4,1,28,47,normal
11,4,1,19,35,normal
19,4,0,17,40,normal
18,3,1,26,48,normal
10,1,1,21,33,normal
20,5,1,40,66,normal
11,5,0,37,53,normal
15,4,1,29,49,normal
16,2,1,27,46,normal
10,3,1,23,37,normal
16,5,1,31,53,normal
20,0,1,30,51,normal
61,4,5,17,87,normal
91,8,6,2,107,low
94,4,5,2,105,low
117,8,6,16,147,normal
111,14,10,14,149,normal
91,2,3,5,101,low
96,9,1,16,122,normal
134,15,42,5,196,heavy
121,35,39,4,199,heavy
118,40,40,3,201,heavy
115,17,40,1,173,heavy
106,22,37,0,165,high
147,26,40,0,213,heavy
102,13,31,2,148,high
102,12,24,3,141,normal
130,40,31,2,203,heavy
102,17,33,0,152,high
105,13,48,5,171,heavy
129,24,25,0,178,heavy
117,11,45,0,173,heavy
74,14,23,21,132,high
80,14,35,18,147,high
31,7,34,24,96,normal
18,15,9,15,57,normal
15,10,23,20,68,normal
37,18,8,16,79,normal
10,7,5,14,36,normal
54,6,15,23,98,normal
34,7,5,24,70,normal
50,7,8,21,86,normal
44,9,10,24,87,normal
63,8,15,24,110,normal
56,6,6,29,97,normal
69,5,13,27,114,high
39,5,3,30,77,normal
61,10,14,24,109,normal
61,30,5,20,116,normal
20,17,9,5,51,low
70,22,38,7,137,high
25,30,31,9,95,normal
23,13,12,6,54,low
105,30,24,8,167,normal
107,10,6,6,129,normal
40,20,36,7,103,normal
74,18,37,11,140,high
62,15,8,11,96,low
81,20,14,12,127,normal
111,32,43,5,191,heavy
145,12,41,6,204,heavy
139,11,20,7,177,heavy
129,40,31,10,210,heavy
128,22,28,8,186,heavy
103,17,23,8,151,normal
127,32,29,7,195,heavy
120,35,44,8,207,heavy
106,11,41,7,165,high
114,40,31,5,190,heavy
101,13,20,7,141,normal
110,25,19,34,188,heavy
108,6,17,23,154,high
104,12,10,10,136,normal
102,22,17,23,164,high
77,19,16,8,120,normal
70,16,19,33,138,high
75,9,13,28,125,high
95,9,16,29,149,high
77,17,17,22,133,high
73,16,14,34,137,high
59,7,18,12,96,normal
54,20,10,9,93,low
90,6,18,32,146,high
15,5,1,32,53,normal
12,1,0,11,24,low
17,2,0,28,47,normal
13,5,1,12,31,low
15,5,0,21,41,normal
18,4,0,11,33,low
12,4,0,21,37,normal
10,4,1,12,27,low
15,2,0,25,42,normal
11,0,0,24,35,normal
15,2,1,15,33,normal
20,3,1,29,53,normal
17,2,0,24,43,normal
19,5,1,26,51,normal
20,3,1,32,56,normal
15,3,0,19,37,normal
13,5,0,17,35,normal
12,5,1,19,37,normal
10,2,0,27,39,normal
20,4,1,23,48,normal
14,0,0,16,30,normal
12,4,1,28,45,normal
19,2,0,20,41,normal
20,2,1,19,42,normal
16,0,0,36,52,normal
62,20,4,18,104,normal
50,13,2,14,79,normal
101,3,6,6,116,normal
94,15,2,9,120,normal
68,10,8,1,87,low
95,3,8,20,126,normal
113,7,10,16,146,normal
106,13,39,1,159,high
105,32,47,4,188,heavy
150,19,34,4,207,heavy
137,38,39,2,216,heavy
113,11,32,1,157,high
117,30,26,5,178,heavy
130,10,37,1,178,heavy
150,32,31,1,214,heavy
146,10,30,3,189,heavy
123,24,46,2,195,heavy
110,24,26,4,164,high
111,33,31,2,177,heavy
132,18,32,2,184,heavy
66,16,22,13,117,normal
45,24,5,23,97,normal
92,19,15,7,133,normal
78,22,16,25,141,high
90,2,15,18,125,normal
23,2,37,9,71,normal
17,5,6,20,48,normal
41,5,4,24,74,normal
32,5,15,26,78,normal
65,7,7,22,101,normal
22,6,3,25,56,normal
54,7,4,28,93,normal
38,5,8,28,79,normal
59,7,15,23,104,normal
34,8,10,23,75,normal
28,6,3,27,64,normal
7,16,11,14,48,normal
8,12,22,8,50,normal
42,25,38,18,123,high
82,13,28,5,128,high
14,24,26,9,73,normal
39,25,33,9,106,normal
47,14,29,6,96,normal
120,20,21,18,179,heavy
114,11,39,10,174,heavy
99,24,30,10,163,high
78,18,30,8,134,high
144,40,29,10,223,normal
107,28,38,9,182,heavy
123,28,24,10,185,heavy
126,15,28,6,175,heavy
147,28,23,5,203,heavy
100,21,33,7,161,high
113,12,22,6,153,normal
130,34,30,6,200,heavy
118,40,29,10,197,heavy
113,38,44,9,204,heavy
117,29,29,9,184,heavy
106,12,20,32,170,heavy
96,11,15,14,136,normal
58,11,14,24,107,normal
76,22,10,9,117,normal
66,6,12,33,117,high
61,23,13,18,115,normal
93,6,15,17,131,normal
51,11,16,26,104,normal
86,6,12,9,113,normal
77,15,12,29,133,high
84,15,16,8,123,normal
103,12,15,10,140,normal
60,9,11,27,107,normal
14,1,1,22,38,normal
14,2,0,35,51,normal
13,1,1,31,46,normal
19,0,1,22,42,normal
13,4,0,28,45,normal
13,1,0,26,40,normal
12,0,1,34,47,normal
20,1,1,38,60,normal
12,3,0,38,53,normal
12,1,0,40,53,normal
20,5,0,10,35,low
12,4,1,27,44,normal
15,5,0,21,41,normal
19,2,0,30,51,normal
11,0,1,40,52,normal
15,3,0,35,53,normal
15,0,1,37,53,normal
16,2,0,37,55,normal
10,0,1,24,35,normal
12,0,1,31,44,normal
15,1,1,36,53,normal
14,5,0,17,36,normal
17,3,1,38,59,normal
19,0,0,18,37,normal
18,5,1,30,54,normal
119,12,6,4,141,normal
74,28,1,13,116,normal
101,26,10,0,137,normal
99,4,7,19,129,normal
99,18,7,5,129,normal
102,24,2,8,136,normal
50,4,6,13,73,normal
128,11,46,4,189,heavy
129,39,43,0,211,heavy
129,27,38,0,194,heavy
113,24,22,2,161,normal
141,15,21,5,182,heavy
120,22,29,1,172,heavy
141,24,47,4,216,heavy
149,24,33,1,207,heavy
140,40,36,1,217,heavy
140,20,36,0,196,heavy
107,13,31,4,155,high
141,15,32,4,192,heavy
120,27,38,4,189,heavy
70,14,21,5,110,normal
55,24,16,21,116,high
52,18,22,16,108,normal
65,4,19,21,109,normal
54,10,30,28,122,high
37,3,32,18,90,normal
23,3,37,18,81,normal
43,7,7,29,86,normal
22,6,13,24,65,normal
21,10,6,30,67,normal
48,8,11,22,89,normal
35,5,12,20,72,normal
69,5,13,22,109,normal
22,9,10,21,62,normal
46,5,9,23,83,normal
49,5,11,21,86,normal
29,18,29,20,96,normal
96,23,31,14,164,high
100,27,23,16,166,normal
96,22,36,5,159,high
27,26,25,15,93,normal
114,21,32,5,172,heavy
74,27,34,10,145,high
14,16,9,14,53,normal
84,30,26,10,150,high
96,19,14,18,147,normal
40,15,28,5,88,normal
110,15,46,5,176,heavy
138,39,31,7,215,heavy
118,32,32,10,192,heavy
142,34,38,9,223,normal
113,13,36,5,167,normal
104,29,32,7,172,heavy
134,39,21,9,203,heavy
107,15,48,5,175,heavy
139,25,43,7,214,heavy
128,20,20,6,174,heavy
101,13,47,10,171,heavy
105,17,13,23,158,high
103,14,13,9,139,normal
51,23,15,13,102,normal
84,10,16,20,130,normal
97,25,19,24,165,high
98,8,10,19,135,normal
94,13,19,25,151,high
105,25,11,35,176,heavy
74,9,13,6,102,low
57,18,13,28,116,high
57,14,11,33,115,high
84,23,19,15,141,normal
105,14,16,33,168,heavy
10,4,1,38,53,normal
15,1,1,29,46,normal
14,1,1,25,41,normal
20,2,0,37,59,normal
20,1,0,27,48,normal
13,1,1,18,33,normal
19,0,0,35,54,normal
14,1,1,27,43,normal
13,5,0,12,30,low
18,5,0,12,35,low
10,3,1,32,46,normal
14,2,0,15,31,normal
16,3,0,15,34,normal
14,2,0,25,41,normal
17,5,0,18,40,normal
13,1,0,28,42,normal
19,0,1,20,40,normal
15,4,0,40,59,normal
14,3,1,26,44,normal
15,4,0,14,33,normal
12,3,1,13,29,normal
12,4,0,31,47,normal
17,4,1,20,42,normal
12,0,1,13,26,normal
18,2,0,16,36,normal
115,16,10,13,154,normal
117,5,10,15,147,normal
92,26,8,7,133,normal
88,3,6,4,101,low
109,11,4,3,127,normal
81,4,0,20,105,normal
118,2,5,19,144,normal
107,26,31,2,166,high
103,11,35,5,154,high
145,13,33,3,194,heavy
143,22,37,4,206,heavy
113,38,50,3,204,heavy
149,10,47,3,209,heavy
132,33,35,2,202,heavy
119,40,41,2,202,heavy
133,31,27,2,193,heavy
140,20,44,4,208,heavy
140,34,31,1,206,heavy
128,37,50,2,217,heavy
132,11,24,3,170,heavy
23,8,40,27,98,normal
75,2,18,29,124,high
99,14,33,14,160,high
10,1,13,7,31,low
74,21,29,26,150,high
29,15,25,5,74,normal
50,17,38,24,129,high
64,9,14,20,107,normal
49,5,10,21,85,normal
39,7,10,30,86,normal
68,5,5,24,102,normal
67,7,8,22,104,normal
47,8,3,25,83,normal
66,9,7,24,106,normal
46,8,3,22,79,normal
54,6,12,21,93,normal
18,16,32,18,84,normal
24,20,7,9,60,low
113,17,16,20,166,normal
52,13,15,10,90,low
58,26,25,18,127,normal
44,19,22,6,91,normal
8,26,34,9,77,normal
31,10,27,8,76,normal
115,24,16,5,160,normal
56,29,16,16,117,normal
7,12,33,12,64,normal
133,10,46,10,199,heavy
104,31,37,6,178,heavy
100,38,36,9,183,heavy
127,25,37,5,194,heavy
118,32,48,6,204,heavy
147,19,31,8,205,heavy
123,36,34,5,198,heavy
111,24,25,5,165,normal
121,16,42,8,187,heavy
119,38,47,7,211,heavy
132,30,41,6,209,heavy
52,6,12,18,88,normal
97,21,10,8,136,normal
50,16,20,31,117,high
94,25,19,8,146,normal
66,11,18,34,129,high
105,16,15,6,142,normal
56,23,10,18,107,normal
105,19,10,25,159,high
60,18,11,16,105,normal
88,10,14,11,123,normal
110,6,14,23,153,high
78,20,11,35,144,high
105,14,10,7,136,normal
18,1,0,10,29,low
18,1,0,27,46,normal
12,4,1,18,35,normal
15,4,1,32,52,normal
13,4,0,32,49,normal
14,4,0,15,33,normal
15,4,0,17,36,normal
14,0,1,21,36,normal
17,5,0,37,59,normal
14,4,1,12,31,low
16,2,0,15,33,normal
13,4,1,14,32,normal
12,4,0,29,45,normal
19,4,1,30,54,normal
18,4,0,18,40,normal
18,1,1,12,32,low
20,4,1,21,46,normal
10,2,1,20,33,normal
18,5,1,23,47,normal
16,5,1,30,52,normal
12,3,0,40,55,normal
12,2,0,40,54,normal
16,0,1,37,54,normal
15,4,1,16,36,normal
13,0,0,38,51,normal
61,5,3,14,83,normal
27,15,6,10,58,low
74,11,5,15,105,normal
70,6,7,14,97,normal
33,6,0,11,50,low
29,12,1,13,55,normal
69,5,7,10,91,low
41,16,7,15,79,normal
35,11,5,11,62,low
25,9,6,14,54,normal
65,15,1,11,92,low
66,6,3,14,89,normal
27,6,5,15,53,normal
75,6,1,10,92,low
54,11,4,12,81,low
54,18,3,12,87,low
69,8,0,14,91,normal
52,19,6,10,87,low
66,8,0,12,86,low
54,11,0,13,78,normal
151,48,15,3,217,heavy
170,62,18,2,252,heavy
134,59,11,3,207,heavy
166,63,22,1,252,heavy
173,64,10,2,249,heavy
176,45,22,2,245,heavy
162,59,27,1,249,heavy
171,46,15,3,235,heavy
158,44,26,2,230,heavy
151,64,16,0,231,heavy
162,65,14,3,244,heavy
179,44,23,1,247,heavy
175,59,11,3,248,heavy
173,63,13,2,251,heavy
144,66,11,3,224,heavy
132,68,22,4,226,heavy
161,50,10,0,221,heavy
151,56,29,1,237,heavy
168,59,24,1,252,heavy
144,65,20,3,232,heavy
179,63,12,2,256,heavy
161,56,12,4,233,heavy
134,67,12,1,214,heavy
140,70,23,4,237,heavy
66,29,24,1,120,normal
60,27,17,2,106,normal
89,27,10,2,128,normal
81,29,5,0,115,normal
78,22,12,1,113,normal
71,24,18,2,115,normal
50,26,9,1,86,low
55,28,5,0,88,low
61,20,25,1,107,normal
76,22,14,2,114,normal
50,20,23,1,94,normal
89,26,0,2,117,normal
62,20,17,0,99,normal
83,20,23,2,128,normal
65,20,2,0,87,low
60,21,2,1,84,low
36,8,3,9,56,low
39,5,4,11,59,low
26,8,3,0,37,low
23,4,0,5,32,low
50,2,0,4,56,low
30,2,3,1,36,low
48,10,4,2,64,low
39,6,6,1,52,low
47,10,3,9,69,low
26,3,5,3,37,low
25,6,3,9,43,low
19,1,0,11,31,low
16,5,0,26,47,normal
15,2,1,39,57,normal
14,5,0,11,30,low
12,2,0,20,34,normal
11,2,0,35,48,normal
18,5,1,11,35,low
17,2,0,20,39,normal
19,5,1,30,55,normal
17,4,1,24,46,normal
16,3,0,14,33,normal
16,3,1,23,43,normal
20,0,1,17,38,normal
20,0,0,37,57,normal
18,0,1,30,49,normal
19,1,0,14,34,normal
18,5,0,29,52,normal
11,1,0,22,34,normal
20,3,0,24,47,normal
12,2,1,10,25,low
19,5,1,31,56,normal
10,0,0,32,42,normal
14,1,1,12,28,low
14,2,1,24,41,normal
10,3,0,32,45,normal
97,23,6,17,143,normal
104,22,7,11,144,normal
100,15,8,20,143,normal
87,7,7,4,105,low
77,27,8,10,122,normal
51,7,4,5,67,low
79,1,10,6,96,low
100,40,29,5,174,heavy
112,13,39,0,164,high
120,16,34,2,172,heavy
123,14,26,3,166,high
142,27,27,4,200,heavy
139,38,49,2,228,heavy
134,24,21,2,181,heavy
102,13,31,0,146,high
102,16,43,4,165,high
106,16,32,1,155,high
117,19,42,3,181,heavy
139,36,40,3,218,heavy
121,13,25,2,161,normal
65,19,16,11,111,normal
12,25,39,28,104,normal
98,21,10,5,134,normal
58,9,25,13,105,normal
81,10,39,29,159,high
67,20,33,29,149,high
68,22,25,16,131,normal
47,10,6,22,85,normal
45,7,10,27,89,normal
54,5,11,24,94,normal
61,7,15,28,111,normal
56,5,4,29,94,normal
23,5,4,27,59,normal
31,6,8,23,68,normal
27,7,14,28,76,normal
30,7,3,30,70,normal
114,21,5,14,154,normal
46,24,35,16,121,high
68,29,29,20,146,high
45,16,15,5,81,low
86,13,11,20,130,normal
44,11,19,15,89,normal
45,17,13,20,95,normal
106,17,7,12,142,normal
44,16,9,13,82,normal
77,23,13,9,122,normal
53,17,26,8,104,normal
138,18,20,8,184,heavy
142,24,39,9,214,heavy
114,25,21,7,167,normal
116,35,42,6,199,heavy
149,22,37,8,216,heavy
100,12,39,7,158,high
101,23,45,5,174,heavy
122,40,48,10,220,heavy
112,34,39,9,194,heavy
112,12,41,5,170,heavy
116,22,23,7,168,heavy
90,13,15,33,151,high
85,14,14,13,126,normal
59,25,13,27,124,high
108,5,15,22,150,high
75,8,16,25,124,high
96,15,12,27,150,high
61,17,10,8,96,low
84,25,20,30,159,high
55,9,12,19,95,normal
65,16,12,32,125,high
87,16,10,16,129,normal
75,5,12,21,113,high
82,16,14,34,146,high
11,3,0,34,48,normal
15,5,0,14,34,normal
18,5,1,13,37,normal
19,2,1,34,56,normal
20,4,1,26,51,normal
14,4,0,10,28,low
11,1,1,36,49,normal
10,2,1,15,28,normal
10,3,0,33,46,normal
14,3,0,23,40,normal
11,5,1,11,28,low
10,1,1,34,46,normal
20,4,1,17,42,normal
17,5,0,24,46,normal
12,2,1,18,33,normal
15,0,1,16,32,normal
19,5,0,15,39,normal
11,3,1,39,54,normal
14,5,0,10,29,low
20,0,1,33,54,normal
13,1,1,33,48,normal
18,2,1,12,33,low
19,2,1,23,45,normal
10,4,0,36,50,normal
13,4,0,17,34,normal
86,28,2,18,134,normal
59,29,9,14,111,normal
102,20,9,13,144,normal
114,28,8,16,166,normal
87,23,5,0,115,normal
88,5,8,13,114,normal
83,6,4,9,102,low
150,19,24,3,196,heavy
148,35,46,1,230,heavy
146,23,23,4,196,heavy
140,21,39,3,203,heavy
149,36,35,1,221,heavy
125,34,42,0,201,heavy
147,34,20,5,206,heavy
128,33,21,4,186,heavy
111,38,50,5,204,heavy
144,20,32,4,200,heavy
121,14,23,1,159,normal
136,36,40,4,216,heavy
114,21,23,1,159,normal
75,17,37,29,158,high
34,5,27,22,88,normal
45,6,7,15,73,normal
65,10,6,27,108,normal
67,25,20,18,130,normal
50,25,25,28,128,high
37,19,38,12,106,normal
36,8,3,29,76,normal
63,5,8,23,99,normal
67,5,7,22,101,normal
36,9,14,22,81,normal
57,8,10,22,97,normal
65,7,14,25,111,normal
54,10,3,29,96,normal
41,5,4,25,75,normal
43,9,3,25,80,normal
9,27,32,17,85,normal
101,28,18,20,167,normal
99,16,16,18,149,normal
20,27,32,12,91,normal
96,16,39,17,168,heavy
62,28,18,20,128,normal
58,27,17,5,107,normal
60,18,28,12,118,high
81,26,13,17,137,normal
118,15,27,13,173,heavy
53,12,25,20,110,normal
132,12,27,9,180,heavy
149,14,50,5,218,heavy
106,35,41,5,187,heavy
150,29,27,7,213,heavy
110,30,46,5,191,heavy
129,35,34,5,203,heavy
133,21,26,5,185,heavy
148,34,45,7,234,heavy
144,39,43,8,234,heavy
126,27,44,8,205,heavy
103,34,49,5,191,heavy
96,7,13,30,146,high
54,17,17,19,107,normal
98,16,17,15,146,normal
72,6,19,8,105,normal
69,23,12,31,135,high
85,13,16,24,138,high
102,22,12,9,145,normal
103,14,20,14,151,normal
80,12,10,22,124,high
63,18,11,5,97,low
84,21,13,9,127,normal
72,10,10,29,121,high
79,22,17,13,131,normal
12,5,0,27,44,normal
19,1,1,38,59,normal
14,3,0,33,50,normal
16,3,1,37,57,normal
14,5,0,37,56,normal
11,2,1,20,34,normal
20,3,0,25,48,normal
20,0,1,30,51,normal
13,2,1,17,33,normal
20,1,1,19,41,normal
10,2,1,12,25,low
14,2,0,25,41,normal
12,0,1,16,29,normal
11,5,1,31,48,normal
13,1,1,16,31,normal
17,3,0,10,30,low
11,1,0,22,34,normal
10,4,1,16,31,normal
15,3,1,32,51,normal
10,0,0,22,32,normal
20,1,1,16,38,normal
16,1,1,15,33,normal
14,4,1,32,51,normal
16,1,1,37,55,normal
10,2,1,36,49,normal
96,18,7,2,123,normal
51,14,0,5,70,low
63,25,2,8,98,low
72,7,1,4,84,low
86,18,6,1,111,low
105,4,4,20,133,normal
117,10,10,18,155,normal
120,36,32,0,188,heavy
135,20,31,0,186,heavy
112,40,42,3,197,heavy
135,13,20,3,171,heavy
105,35,24,2,166,normal
150,25,36,0,211,heavy
108,27,23,2,160,normal
108,40,45,1,194,heavy
118,19,21,1,159,normal
131,18,41,1,191,heavy
148,31,20,4,203,heavy
120,26,22,1,169,heavy
147,12,32,0,191,heavy
73,9,35,12,129,high
93,21,22,29,165,high
66,2,10,28,106,normal
18,6,6,6,36,low
78,1,16,30,125,high
69,15,24,20,128,normal
82,2,40,17,141,high
57,9,5,23,94,normal
25,5,14,26,70,normal
40,9,15,28,92,normal
52,6,13,21,92,normal
45,8,13,29,95,normal
67,10,7,25,109,normal
20,8,14,30,72,normal
44,8,4,29,85,normal
63,5,8,29,105,normal
119,15,20,13,167,normal
103,10,23,7,143,normal
42,14,15,14,85,normal
67,20,24,12,123,normal
56,18,29,17,120,high
65,16,32,15,128,high
107,11,26,19,163,high
11,18,22,10,61,normal
28,15,27,12,82,normal
45,17,7,6,75,low
66,12,27,6,111,normal
104,40,22,9,175,heavy
113,21,26,5,165,high
120,29,37,6,192,heavy
129,10,39,6,184,heavy
119,29,40,10,198,heavy
119,25,32,9,185,heavy
123,10,30,7,170,heavy
111,33,28,5,177,heavy
110,12,47,8,177,heavy
139,15,43,9,206,heavy
132,29,25,7,193,heavy
51,8,18,18,95,normal
76,5,14,20,115,normal
53,15,13,23,104,normal
50,25,19,9,103,normal
86,24,20,34,164,high
67,23,14,13,117,normal
54,9,15,7,85,low
59,12,16,35,122,high
109,25,15,5,154,normal
73,18,10,35,136,high
65,24,14,19,122,normal
94,10,11,22,137,high
106,9,12,31,158,high
18,3,0,11,32,low
17,1,1,36,55,normal
12,0,0,22,34,normal
11,1,0,19,31,normal
16,1,0,32,49,normal
12,3,1,13,29,normal
14,4,1,27,46,normal
11,3,1,37,52,normal
17,2,0,18,37,normal
18,4,1,39,62,normal
20,4,0,32,56,normal
15,0,0,28,43,normal
11,4,0,12,27,low
19,5,1,35,60,normal
15,0,1,26,42,normal
11,4,0,31,46,normal
19,2,1,33,55,normal
12,4,1,29,46,normal
15,5,1,16,37,normal
14,4,1,21,40,normal
19,4,1,17,41,normal
10,2,1,12,25,low
10,0,0,11,21,low
20,4,1,33,58,normal
10,1,0,12,23,low
73,12,5,5,95,low
95,15,4,19,133,normal
81,19,3,13,116,normal
119,25,10,9,163,normal
80,10,4,15,109,normal
102,24,3,16,145,normal
68,17,6,10,101,low
109,40,38,0,187,heavy
124,25,31,1,181,heavy
126,22,21,1,170,heavy
120,31,29,5,185,heavy
101,20,47,5,173,heavy
139,40,48,2,229,heavy
116,23,23,4,166,normal
101,14,24,0,139,normal
137,40,21,5,203,heavy
131,26,36,0,193,heavy
114,27,45,4,190,heavy
102,14,46,1,163,high
116,24,32,5,177,heavy
29,10,21,12,72,normal
41,12,15,10,78,low
41,9,7,27,84,normal
90,25,26,10,151,high
64,25,17,20,126,normal
64,10,17,23,114,high
69,17,5,28,119,high
59,9,9,21,98,normal
44,10,12,29,95,normal
43,5,6,26,80,normal
65,7,10,21,103,normal
29,5,12,21,67,normal
24,9,8,20,61,normal
44,6,4,26,80,normal
35,10,12,24,81,normal
43,10,15,21,89,normal
45,17,24,11,97,normal
108,21,37,14,180,heavy
53,19,33,9,114,high
75,23,31,13,142,high
70,18,5,19,112,normal
52,25,15,19,111,normal
9,18,24,9,60,normal
47,21,9,18,95,normal
116,20,17,19,172,heavy
65,14,6,9,94,low
93,12,13,13,131,normal
100,21,45,9,175,heavy
121,24,31,6,182,heavy
110,15,50,5,180,heavy
103,17,28,5,153,high
136,38,20,5,199,heavy
119,22,32,9,182,heavy
132,17,36,5,190,heavy
147,10,41,5,203,heavy
111,12,44,6,173,heavy
102,27,32,5,166,high
137,25,29,7,198,heavy
71,17,15,31,134,high
64,25,11,15,115,normal
70,16,15,29,130,high
91,9,11,32,143,high
95,6,11,35,147,high
76,16,10,31,133,high
87,17,18,7,129,normal
63,22,12,29,126,high
56,17,20,8,101,normal
102,18,19,29,168,heavy
60,23,10,13,106,normal
88,6,18,25,137,high
104,15,10,32,161,high
16,1,1,26,44,normal
12,1,0,12,25,low
16,1,0,29,46,normal
13,5,0,31,49,normal
20,1,1,27,49,normal
18,0,0,29,47,normal
16,3,1,26,46,normal
18,0,0,21,39,normal
11,5,0,24,40,normal
13,1,0,10,24,low
10,1,0,26,37,normal
19,5,1,22,47,normal
20,0,0,10,30,low
16,4,1,39,60,normal
19,1,1,11,32,low
20,4,0,38,62,normal
15,1,1,15,32,normal
10,0,0,33,43,normal
20,5,0,24,49,normal
12,2,1,35,50,normal
10,4,1,37,52,normal
15,4,0,38,57,normal
19,0,1,39,59,normal
16,4,0,35,55,normal
20,3,1,35,59,normal
118,1,0,4,123,normal
89,20,4,17,130,normal
120,18,6,13,157,normal
85,7,3,18,113,normal
99,8,2,14,123,normal
59,25,2,7,93,low
58,25,2,5,90,low
113,40,36,4,193,heavy
113,16,50,2,181,heavy
121,27,50,4,202,heavy
150,17,28,0,195,heavy
136,29,23,0,188,heavy
142,32,27,2,203,heavy
106,32,42,2,182,heavy
103,21,20,0,144,normal
131,19,26,1,177,heavy
133,23,21,3,180,heavy
123,17,50,1,191,heavy
124,21,35,2,182,heavy
136,26,20,4,186,heavy
92,10,39,19,160,high
82,7,13,19,121,normal
42,2,28,27,99,normal
24,17,17,9,67,normal
42,19,17,12,90,normal
100,12,5,23,140,high
11,25,30,22,88,normal
27,7,10,22,66,normal
38,7,11,20,76,normal
49,10,6,27,92,normal
66,9,7,28,110,normal
70,8,3,22,103,normal
58,7,6,27,98,normal
53,9,13,29,104,normal
22,5,6,26,59,normal
40,10,11,28,89,normal
58,13,10,12,93,low
60,25,24,17,126,normal
25,11,24,17,77,normal
22,28,11,18,79,normal
6,11,37,15,69,normal
92,18,34,18,162,high
97,17,38,20,172,heavy
92,18,31,6,147,high
74,12,17,16,119,normal
67,22,7,5,101,low
84,20,25,15,144,normal
144,15,42,8,209,heavy
120,11,47,7,185,heavy
108,10,36,6,160,high
141,13,50,6,210,heavy
121,37,29,8,195,heavy
142,40,22,6,210,heavy
137,23,28,7,195,heavy
117,10,27,8,162,high
100,16,37,7,160,high
148,11,42,8,209,heavy
148,27,39,6,220,heavy
65,18,20,21,124,high
75,9,14,6,104,low
85,15,20,29,149,high
57,21,20,18,116,normal
50,7,13,30,100,normal
87,21,14,34,156,high
64,24,11,6,105,low
76,6,18,14,114,normal
69,11,12,8,100,low
76,9,17,14,116,normal
94,8,15,5,122,normal
104,10,16,33,163,high
98,13,13,33,157,high
13,5,0,18,36,normal
17,1,0,11,29,low
18,2,1,34,55,normal
11,1,0,35,47,normal
17,4,0,11,32,low
17,1,1,23,42,normal
17,2,0,23,42,normal
16,4,1,30,51,normal
15,5,1,23,44,normal
18,0,0,31,49,normal
10,1,0,17,28,normal
13,2,0,32,47,normal
16,1,0,38,55,normal
11,4,0,32,47,normal
12,2,0,26,40,normal
14,2,1,14,31,normal
18,2,0,37,57,normal
17,1,1,22,41,normal
12,3,0,29,44,normal
20,5,0,30,55,normal
17,5,1,19,42,normal
12,0,1,33,46,normal
19,1,0,20,40,normal
11,4,1,38,54,normal
14,5,0,39,58,normal
102,20,4,12,138,normal
92,4,6,18,120,normal
54,14,10,16,94,normal
55,15,1,10,81,low
64,27,5,5,101,low
52,13,5,15,85,normal
73,11,4,3,91,low
106,27,45,5,183,heavy
145,21,40,5,211,heavy
133,19,28,5,185,heavy
117,31,49,0,197,heavy
146,17,34,0,197,heavy
101,35,42,3,181,heavy
103,28,32,1,164,high
150,10,26,0,186,heavy
135,23,48,0,206,heavy
104,10,48,2,164,high
144,39,50,1,234,heavy
132,10,49,0,191,heavy
142,19,31,1,193,heavy
45,4,30,29,108,normal
27,24,10,5,66,low
85,3,14,16,118,normal
84,11,27,26,148,high
90,4,10,20,124,normal
13,19,39,12,83,normal
11,1,37,9,58,normal
57,10,4,27,98,normal
52,10,9,23,94,normal
38,7,13,21,79,normal
35,7,15,24,81,normal
60,10,12,21,103,normal
70,10,3,30,113,high
34,8,6,30,78,normal
44,6,4,27,81,normal
21,5,4,25,55,normal
106,10,11,11,138,normal
82,30,32,10,154,high
57,12,9,17,95,normal
60,18,21,10,109,normal
79,17,34,8,138,high
78,29,22,13,142,normal
69,14,32,18,133,high
84,25,5,9,123,normal
62,11,28,5,106,normal
33,17,22,18,90,normal
14,21,23,6,64,normal
127,27,40,5,199,heavy
136,10,27,7,180,heavy
148,14,37,9,208,heavy
122,16,28,6,172,heavy
132,12,45,9,198,heavy
136,29,29,10,204,heavy
103,33,48,10,194,heavy
132,37,23,10,202,heavy
136,39,39,6,220,heavy
120,24,36,5,185,heavy
126,34,38,9,207,heavy
80,22,14,18,134,normal
99,9,15,29,152,high
81,21,19,7,128,normal
87,9,16,26,138,high
80,17,13,30,140,high
91,18,18,9,136,normal
90,19,15,13,137,normal
107,19,10,23,159,high
98,11,14,27,150,high
98,18,20,22,158,high
102,5,12,17,136,normal
62,13,16,28,119,high
101,15,12,35,163,high
17,5,1,16,39,normal
10,4,1,37,52,normal
16,4,0,35,55,normal
17,2,0,17,36,normal
17,0,0,27,44,normal
17,4,1,25,47,normal
15,2,0,15,32,normal
20,0,1,12,33,low
16,3,0,28,47,normal
13,2,1,28,44,normal
15,5,0,26,46,normal
15,2,1,16,34,normal
12,3,0,26,41,normal
15,5,0,27,47,normal
20,2,0,17,39,normal
12,2,0,16,30,normal
19,1,0,38,58,normal
16,1,1,32,50,normal
12,0,0,11,23,low
16,5,1,29,51,normal
19,5,1,18,43,normal
11,0,0,15,26,normal
15,4,1,17,37,normal
20,1,0,23,44,normal
10,4,0,36,50,normal
39,14,0,15,68,normal
33,7,3,10,53,low
77,8,7,15,107,normal
80,18,6,11,115,normal
53,11,7,15,86,normal
73,17,6,13,109,normal
77,20,4,13,114,normal
76,14,1,12,103,low
58,14,0,15,87,normal
57,18,7,13,95,normal
80,16,0,10,106,low
38,7,1,13,59,normal
53,20,6,12,91,low
30,9,7,10,56,low
50,19,4,10,83,low
31,14,3,14,62,normal
28,18,5,10,61,low
31,15,4,12,62,low
52,19,0,10,81,low
42,9,2,13,66,normal
151,55,27,2,235,heavy
180,69,29,1,279,heavy
149,41,23,3,216,heavy
167,60,27,3,257,heavy
134,45,22,3,204,heavy
180,62,26,4,272,heavy
156,54,25,3,238,heavy
171,60,18,1,250,heavy
174,53,10,3,240,heavy
154,61,16,3,234,heavy
161,53,11,1,226,heavy
148,48,13,2,211,heavy
136,60,27,2,225,heavy
143,68,16,0,227,heavy
152,51,22,2,227,heavy
132,58,15,4,209,heavy
155,58,15,4,232,heavy
144,62,12,3,221,heavy
161,51,20,1,233,heavy
137,46,13,2,198,heavy
149,61,16,1,227,heavy
158,46,20,1,225,heavy
134,65,22,0,221,heavy
134,65,10,2,211,heavy
73,24,4,0,101,low
64,23,21,1,109,normal
51,27,25,2,105,normal
80,22,17,0,119,normal
61,26,8,0,95,low
75,24,8,0,107,low
82,20,15,2,119,normal
53,28,21,1,103,normal
68,29,14,0,111,low
63,28,22,0,113,normal
76,30,20,1,127,normal
66,23,10,0,99,low
50,23,1,0,74,low
60,29,22,2,113,normal
75,26,11,0,112,normal
81,22,18,2,123,normal
33,6,0,4,43,low
21,5,6,15,47,normal
22,7,1,2,32,low
31,6,0,15,52,normal
41,8,3,2,54,low
24,6,5,11,46,low
45,6,6,10,67,low
24,11,6,2,43,low
47,6,2,12,67,low
46,1,1,4,52,low
26,3,2,3,34,low
20,4,0,39,63,normal
20,1,1,27,49,normal
19,0,1,17,37,normal
11,3,1,19,34,normal
17,5,1,31,54,normal
19,4,0,12,35,low
11,1,0,38,50,normal
12,0,0,17,29,normal
18,0,0,27,45,normal
19,4,0,14,37,normal
13,2,0,28,43,normal
18,4,1,23,46,normal
20,0,0,11,31,low
11,4,1,22,38,normal
15,2,0,18,35,normal
16,3,0,34,53,normal
11,2,0,18,31,normal
17,4,1,38,60,normal
20,4,1,28,53,normal
19,0,1,37,57,normal
10,2,1,34,47,normal
19,0,0,17,36,normal
15,0,0,30,45,normal
10,2,0,31,43,normal
18,3,0,17,38,normal
97,22,4,18,141,normal
111,12,9,17,149,normal
108,10,5,17,140,normal
74,24,10,20,128,normal
114,4,8,20,146,normal
91,16,5,11,123,normal
66,3,9,19,97,normal
104,32,23,5,164,normal
128,18,31,3,180,heavy
127,24,27,0,178,heavy
130,31,22,0,183,heavy
108,13,38,1,160,high
116,22,37,2,177,heavy
143,28,27,4,202,heavy
118,32,21,5,176,heavy
121,35,32,0,188,heavy
109,28,39,2,178,heavy
135,11,23,5,174,heavy
100,30,29,2,161,high
138,32,26,4,200,heavy
29,9,21,23,82,normal
36,17,7,30,90,normal
42,9,37,28,116,high
80,6,12,6,104,low
37,21,28,6,92,normal
44,17,27,30,118,high
25,12,13,5,55,low
36,9,9,30,84,normal
63,7,10,29,109,normal
20,5,13,22,60,normal
53,8,6,23,90,normal
41,7,5,26,79,normal
36,9,13,29,87,normal
65,10,8,22,105,normal
55,6,5,27,93,normal
63,8,15,30,116,high
19,26,32,18,95,normal
84,11,11,9,115,normal
110,23,34,9,176,heavy
46,20,18,5,89,normal
67,12,10,20,109,normal
42,25,20,19,106,normal
87,17,18,6,128,normal
45,24,31,11,111,normal
80,26,35,6,147,high
83,18,6,15,122,normal
68,19,15,11,113,normal
101,37,48,9,195,heavy
149,32,29,10,220,heavy
136,21,33,9,199,heavy
105,20,23,7,155,normal
125,12,20,8,165,normal
125,14,26,5,170,heavy
118,28,23,8,177,heavy
114,32,45,6,197,heavy
123,37,46,8,214,heavy
115,23,22,7,167,normal
111,25,35,10,181,heavy
66,8,11,9,94,low
103,12,17,23,155,high
94,14,14,24,146,high
105,23,15,18,161,normal
53,22,14,35,124,high
74,10,12,32,128,high
71,24,15,26,136,high
61,21,15,32,129,high
101,25,18,8,152,normal
104,22,10,14,150,normal
79,20,15,18,132,normal
70,20,11,14,115,normal
74,16,14,34,138,high
20,5,0,21,46,normal
16,0,0,36,52,normal
14,3,0,20,37,normal
14,1,1,30,46,normal
17,0,1,12,30,low
14,0,0,14,28,normal
18,5,0,40,63,normal
17,2,0,18,37,normal
14,1,1,35,51,normal
14,2,1,26,43,normal
16,0,1,37,54,normal
14,4,1,32,51,normal
19,5,0,12,36,low
11,0,1,31,43,normal
12,0,0,32,44,normal
12,3,0,32,47,normal
18,4,1,31,54,normal
17,4,1,20,42,normal
17,0,0,22,39,normal
19,2,1,12,34,low
18,2,1,19,40,normal
19,5,0,26,50,normal
19,5,1,35,60,normal
18,0,0,20,38,normal
16,0,0,30,46,normal
114,30,9,7,160,normal
102,17,2,14,135,normal
55,4,7,13,79,normal
82,2,4,14,102,normal
66,16,9,19,110,normal
86,5,1,13,105,normal
108,24,2,19,153,normal
112,30,26,0,168,heavy
147,31,46,0,224,heavy
116,20,40,2,178,heavy
138,13,21,5,177,heavy
132,25,40,2,199,heavy
124,14,31,4,173,heavy
106,27,25,1,159,normal
104,24,29,5,162,high
140,31,21,4,196,heavy
121,35,37,3,196,heavy
135,23,37,5,200,heavy
149,20,30,5,204,heavy
117,14,39,0,170,heavy
39,8,23,13,83,normal
40,14,18,21,93,normal
49,1,35,18,103,normal
38,12,35,25,110,normal
26,15,25,6,72,normal
93,14,10,25,142,high
54,24,37,20,135,high
32,6,10,23,71,normal
43,7,12,23,85,normal
23,6,15,20,64,normal
26,5,8,25,64,normal
55,7,8,27,97,normal
70,10,8,25,113,high
66,10,3,29,108,normal
66,7,15,26,114,high
46,6,7,21,80,normal
47,26,6,20,99,normal
75,20,7,11,113,normal
76,29,15,19,139,normal
56,14,38,12,120,high
19,26,36,17,98,normal
29,18,10,9,66,low
15,12,18,15,60,normal
53,27,27,17,124,high
95,22,28,9,154,high
27,27,32,10,96,normal
68,28,31,15,142,high
120,14,25,8,167,normal
144,28,24,8,204,heavy
112,31,43,8,194,heavy
149,28,20,10,207,heavy
131,29,34,8,202,heavy
104,31,41,9,185,heavy
141,30,27,7,205,heavy
117,10,47,9,183,heavy
112,13,37,6,168,heavy
127,40,39,8,214,heavy
131,15,31,6,183,heavy
66,8,10,11,95,low
61,23,18,34,136,high
55,25,13,26,119,high
85,23,20,6,134,normal
75,20,19,19,133,normal
58,17,20,22,117,high
60,23,11,26,120,high
80,21,11,7,119,normal
74,9,14,35,132,high
57,14,11,16,98,normal
73,9,13,5,100,low
80,25,19,26,150,high
82,13,12,21,128,high
15,4,0,27,46,normal
20,2,0,29,51,normal
12,2,0,39,53,normal
10,4,1,13,28,normal
16,0,1,29,46,normal
18,0,0,34,52,normal
11,5,1,19,36,normal
16,1,0,12,29,low
13,3,1,12,29,low
19,2,0,22,43,normal
13,3,0,39,55,normal
12,0,0,24,36,normal
10,3,1,12,26,low
11,4,0,38,53,normal
18,4,0,31,53,normal
19,1,0,34,54,normal
18,1,0,27,46,normal
13,0,0,26,39,normal
12,2,0,35,49,normal
15,4,0,12,31,low
10,5,0,33,48,normal
14,0,0,15,29,normal
16,0,0,16,32,normal
15,3,1,26,45,normal
20,4,0,34,58,normal
82,20,10,11,123,normal
99,7,3,6,115,normal
74,29,9,4,116,normal
94,1,1,14,110,normal
63,12,10,17,102,normal
101,4,3,12,120,normal
106,9,3,10,128,normal
112,15,24,1,152,normal
148,26,25,0,199,heavy
115,20,31,3,169,heavy
125,11,24,0,160,normal
140,38,38,0,216,heavy
150,17,35,5,207,heavy
149,11,42,2,204,heavy
150,22,38,3,213,heavy
147,32,25,4,208,heavy
138,39,45,4,226,heavy
149,16,49,1,215,heavy
139,10,50,2,201,heavy
109,25,49,2,185,heavy
84,24,12,28,148,high
38,8,6,5,57,low
45,16,6,21,88,normal
57,4,36,14,111,normal
84,12,6,28,130,high
55,25,33,21,134,high
14,15,5,21,55,normal
26,8,11,20,65,normal
60,10,9,27,106,normal
34,6,7,25,72,normal
22,9,8,26,65,normal
59,10,11,30,110,normal
48,6,14,28,96,normal
46,9,11,23,89,normal
37,9,8,20,74,normal
67,9,11,21,108,normal
32,19,39,9,99,normal
63,12,22,5,102,normal
32,29,25,11,97,normal
83,22,40,20,165,high
40,14,31,19,104,normal
101,22,39,19,181,heavy
62,29,31,11,133,high
20,19,25,8,72,normal
42,22,5,9,78,low
37,17,12,16,82,normal
95,12,20,15,142,normal
137,14,41,10,202,heavy
122,21,20,10,173,heavy
104,19,39,9,171,heavy
147,21,40,9,217,heavy
105,38,34,7,184,heavy
124,23,46,5,198,heavy
135,18,20,5,178,heavy
107,35,23,8,173,heavy
109,21,24,10,164,normal
136,32,26,8,202,heavy
134,23,49,8,214,heavy
90,20,11,25,146,high
104,5,16,16,141,normal
60,21,13,6,100,low
104,22,11,13,150,normal
54,23,10,25,112,high
68,6,15,34,123,high
88,13,19,19,139,normal
64,22,16,16,118,normal
58,24,14,24,120,high
67,19,12,9,107,low
73,20,18,7,118,normal
109,25,16,20,170,heavy
63,15,11,23,112,high
19,4,1,26,50,normal
15,1,0,34,50,normal
15,5,1,14,35,normal
19,3,1,33,56,normal
18,4,0,11,33,low
14,1,0,27,42,normal
19,0,0,37,56,normal
19,0,0,29,48,normal
18,1,0,30,49,normal
19,3,0,18,40,normal
15,2,1,34,52,normal
17,0,1,14,32,normal
12,0,0,33,45,normal
20,0,1,20,41,normal
10,2,0,18,30,normal
13,3,0,31,47,normal
10,0,1,38,49,normal
19,1,1,28,49,normal
19,4,0,16,39,normal
16,1,0,15,32,normal
17,1,0,34,52,normal
19,1,0,21,41,normal
10,1,0,39,50,normal
16,4,0,15,35,normal
13,0,0,16,29,normal
98,5,1,17,121,normal
65,10,3,8,86,low
98,17,0,20,135,normal
60,20,5,6,91,low
110,18,10,11,149,normal
70,13,4,13,100,normal
96,12,7,17,132,normal
129,31,36,1,197,heavy
146,28,47,3,224,heavy
137,23,27,0,187,heavy
131,28,24,0,183,heavy
134,10,44,0,188,heavy
109,25,24,0,158,normal
108,35,22,3,168,heavy
146,14,37,2,199,heavy
147,21,41,5,214,heavy
110,34,35,0,179,heavy
110,40,50,2,202,heavy
123,12,22,3,160,normal
145,25,20,5,195,heavy
82,15,16,29,142,high
62,2,7,22,93,normal
92,8,11,21,132,high
35,22,22,18,97,normal
66,25,13,13,117,normal
50,2,25,12,89,normal
50,22,24,7,103,normal
50,8,5,24,87,normal
55,5,5,21,86,normal
51,10,14,24,99,normal
34,8,14,21,77,normal
25,7,5,20,57,normal
59,7,9,21,96,normal
38,10,9,24,81,normal
70,10,9,23,112,high
63,8,13,22,106,normal
6,24,12,13,55,normal
108,17,16,16,157,normal
41,20,32,12,105,normal
54,10,20,9,93,normal
60,19,14,7,100,low
102,11,9,11,133,normal
50,24,30,5,109,normal
25,24,19,10,78,normal
90,25,18,20,153,normal
86,13,27,11,137,high
44,19,17,9,89,normal
126,24,35,8,193,heavy
146,26,42,9,223,normal
117,28,33,10,188,heavy
144,36,49,10,239,heavy
137,19,23,9,188,heavy
118,19,48,5,190,heavy
119,27,28,8,182,heavy
149,26,43,5,223,normal
117,34,36,10,197,heavy
124,30,44,10,208,heavy
141,36,48,5,230,heavy
78,6,11,28,123,high
102,23,16,24,165,high
104,18,18,23,163,high
95,9,19,7,130,normal
105,13,12,20,150,normal
100,18,16,34,168,heavy
80,14,20,15,129,normal
86,8,19,7,120,normal
108,20,14,15,157,normal
69,13,13,8,103,low
64,14,10,6,94,low
71,14,17,10,112,normal
61,9,18,24,112,high
11,4,0,31,46,normal
17,5,0,14,36,normal
15,5,0,18,38,normal
14,2,0,40,56,normal
12,2,1,28,43,normal
18,0,1,40,59,normal
14,5,0,13,32,normal
18,1,0,26,45,normal
14,0,0,34,48,normal
17,5,0,23,45,normal
19,1,1,18,39,normal
15,5,1,12,33,low
13,2,1,26,42,normal
15,3,0,32,50,normal
15,0,1,13,29,normal
18,5,1,12,36,low
17,1,0,29,47,normal
10,4,0,19,33,normal
15,0,0,18,33,normal
11,0,0,35,46,normal
20,5,1,34,60,normal
15,5,1,32,53,normal
16,4,1,37,58,normal
14,1,0,12,27,low
16,4,0,18,38,normal
56,21,3,0,80,low
78,11,10,18,117,normal
82,29,0,20,131,normal
102,15,2,7,126,normal
69,14,6,18,107,normal
87,24,6,19,136,normal
84,16,10,5,115,normal
109,38,34,5,186,heavy
147,38,23,3,211,heavy
135,19,48,5,207,heavy
101,23,41,5,170,heavy
138,21,28,1,188,heavy
136,20,32,1,189,heavy
123,19,25,5,172,heavy
108,30,46,5,189,heavy
128,15,43,5,191,heavy
129,37,41,1,208,heavy
127,18,28,3,176,heavy
142,37,46,3,228,heavy
149,26,46,1,222,heavy
77,13,7,23,120,high
37,16,13,29,95,normal
79,8,16,12,115,normal
97,2,16,7,122,normal
22,8,31,8,69,normal
31,23,19,12,85,normal
49,22,16,5,92,normal
32,5,3,21,61,normal
40,6,11,28,85,normal
42,6,10,21,79,normal
37,9,7,25,78,normal
45,5,5,24,79,normal
64,10,4,28,106,normal
33,8,6,23,70,normal
34,6,12,27,79,normal
40,9,5,20,74,normal
64,19,22,12,117,normal
108,24,34,7,173,heavy
108,17,33,7,165,high
50,23,21,11,105,normal
16,21,10,16,63,normal
91,22,34,8,155,high
89,19,37,18,163,high
108,12,23,8,151,normal
73,29,23,7,132,normal
76,28,39,14,157,high
19,15,20,17,71,normal
102,37,48,9,196,heavy
115,36,41,8,200,heavy
142,23,23,6,194,heavy
134,15,29,8,186,heavy
146,18,49,9,222,heavy
126,24,48,9,207,heavy
138,18,27,6,189,heavy
129,13,43,6,191,heavy
127,35,23,10,195,heavy
144,20,22,7,193,heavy
117,19,31,7,174,heavy
87,10,13,16,126,normal
87,6,18,30,141,high
97,18,10,24,149,high
71,21,14,12,118,normal
96,24,18,10,148,normal
90,7,17,31,145,high
74,6,12,34,126,high
59,7,15,20,101,normal
87,11,16,28,142,high
62,22,20,20,124,normal
71,16,14,9,110,low
98,9,15,18,140,normal
93,8,10,16,127,normal
17,4,0,36,57,normal
16,1,1,29,47,normal
15,2,0,10,27,low
10,3,1,23,37,normal
12,4,0,31,47,normal
20,1,1,24,46,normal
11,0,1,23,35,normal
14,1,1,17,33,normal
12,5,1,38,56,normal
15,4,1,29,49,normal
12,4,0,40,56,normal
11,5,0,22,38,normal
14,5,1,21,41,normal
14,3,0,39,56,normal
10,4,1,11,26,low
11,0,0,16,27,normal
12,3,0,39,54,normal
11,0,1,36,48,normal
16,2,0,35,53,normal
17,3,1,36,57,normal
13,1,1,13,28,normal
14,5,0,19,38,normal
17,5,1,15,38,normal
19,3,0,13,35,normal
19,3,1,12,35,low
54,15,10,8,87,low
107,0,1,2,110,low
116,20,5,14,155,normal
78,2,4,9,93,low
111,22,0,12,145,normal
85,27,7,17,136,normal
95,5,9,20,129,normal
143,33,27,1,204,heavy
133,40,37,0,210,heavy
123,37,34,4,198,heavy
133,34,36,1,204,heavy
101,20,42,4,167,normal
145,10,37,0,192,heavy
141,39,40,5,225,heavy
134,12,22,2,170,heavy
126,10,26,4,166,high
136,22,31,0,189,heavy
128,26,42,4,200,heavy
106,12,28,4,150,high
140,27,36,2,205,heavy
40,20,37,28,125,high
13,25,33,12,83,normal
18,22,26,10,76,normal
59,5,36,12,112,high
48,9,30,14,101,normal
77,23,14,20,134,normal
17,13,13,27,70,normal
36,5,14,25,80,normal
60,10,3,28,101,normal
34,5,4,29,72,normal
63,5,6,20,94,normal
48,10,13,23,94,normal
44,5,5,21,75,normal
62,5,14,23,104,normal
38,8,15,27,88,normal
26,6,9,29,70,normal
78,23,16,13,130,normal
116,21,22,17,176,heavy
94,13,11,16,134,normal
52,19,26,10,107,normal
70,13,12,10,105,low
34,17,21,14,86,normal
16,18,40,6,80,normal
24,20,15,17,76,normal
21,15,33,12,81,normal
100,10,18,7,135,normal
117,22,11,5,155,normal
145,30,40,8,223,normal
113,38,45,7,203,heavy
110,31,37,7,185,heavy
126,15,26,6,173,heavy
100,15,29,7,151,high
147,28,29,10,214,heavy
146,22,50,10,228,heavy
148,23,27,5,203,heavy
149,17,41,9,216,heavy
136,32,41,7,216,heavy
101,22,33,9,165,high
87,18,13,34,152,high
50,21,14,9,94,low
63,23,19,34,139,high
73,9,11,5,98,low
78,13,20,25,136,high
71,22,12,14,119,normal
80,17,11,15,123,normal
62,21,10,35,128,high
100,17,16,33,166,high
95,15,18,9,137,normal
102,14,15,34,165,high
68,12,15,32,127,high
74,5,19,5,103,normal
15,4,1,21,41,normal
16,0,1,24,41,normal
12,0,0,12,24,low
12,5,0,23,40,normal
15,2,1,14,32,normal
10,3,0,23,36,normal
16,2,0,35,53,normal
13,3,0,22,38,normal
13,0,0,32,45,normal
11,1,0,27,39,normal
17,1,0,32,50,normal
11,2,0,17,30,normal
14,1,1,11,27,low
17,2,0,33,52,normal
15,2,1,38,56,normal
13,4,1,24,42,normal
11,5,1,11,28,low
12,3,0,22,37,normal
15,1,0,26,42,normal
13,0,1,34,48,normal
17,5,0,15,37,normal
20,3,1,26,50,normal
18,4,0,30,52,normal
12,1,1,19,33,normal
20,0,0,12,32,low
29,10,0,12,51,low
39,20,1,10,70,low
76,9,7,13,105,normal
33,17,0,13,63,normal
64,14,1,12,91,low
44,7,1,11,63,low
53,8,4,15,80,normal
75,6,7,13,101,normal
60,11,4,10,85,low
35,14,2,14,65,normal
75,20,6,15,116,normal
27,10,2,12,51,low
61,20,7,14,102,normal
72,20,5,15,112,normal
43,18,6,14,81,normal
54,10,4,14,82,normal
30,12,1,14,57,normal
72,8,6,12,98,low
55,17,7,15,94,normal
36,20,0,13,69,normal
168,55,10,0,233,heavy
135,61,28,2,226,heavy
168,68,27,2,265,heavy
139,44,16,1,200,heavy
156,63,12,3,234,heavy
141,51,27,3,222,heavy
144,44,16,3,207,heavy
132,65,23,0,220,heavy
180,48,17,2,247,heavy
140,67,20,4,231,heavy
163,62,12,0,237,heavy
148,70,15,0,233,heavy
134,47,22,3,206,heavy
162,51,13,0,226,heavy
136,49,15,1,201,heavy
147,52,26,0,225,heavy
174,54,25,1,254,heavy
135,69,20,1,225,heavy
142,55,21,1,219,heavy
144,59,14,2,219,heavy
180,49,17,0,246,heavy
153,59,20,4,236,heavy
139,43,27,3,212,heavy
179,60,12,0,251,heavy
76,21,6,1,104,low
59,25,19,1,104,normal
51,20,12,1,84,low
78,24,19,2,123,normal
50,24,11,0,85,low
59,25,8,0,92,low
90,21,0,0,111,low
79,26,21,2,128,normal
56,21,4,1,82,low
70,25,11,2,108,low
54,27,21,2,104,normal
53,22,13,2,90,low
59,27,5,2,93,low
63,30,21,0,114,normal
87,21,16,0,124,normal
71,26,19,1,117,normal
32,5,5,13,55,normal
36,6,7,2,51,low
35,10,0,2,47,low
40,10,5,10,65,low
44,6,1,3,54,low
40,6,1,3,50,low
45,2,7,7,61,low
44,2,6,5,57,low
33,4,4,5,46,low
22,5,3,13,43,normal
33,5,5,1,44,low
10,0,0,29,39,normal
19,3,1,35,58,normal
10,4,0,30,44,normal
12,3,1,25,41,normal
12,1,0,40,53,normal
20,2,0,19,41,normal
18,4,1,11,34,low
19,1,1,37,58,normal
13,2,0,25,40,normal
16,4,1,15,36,normal
10,4,1,16,31,normal
18,3,0,19,40,normal
15,5,0,10,30,low
14,2,1,22,39,normal
15,0,0,15,30,normal
17,5,0,21,43,normal
14,0,1,12,27,low
10,1,0,11,22,low
18,5,0,18,41,normal
12,4,0,11,27,low
17,0,1,30,48,normal
20,1,0,28,49,normal
19,5,1,38,63,normal
15,0,0,36,51,normal
10,2,0,30,42,normal
74,4,4,13,95,normal
96,29,6,17,148,normal
109,16,6,12,143,normal
113,6,9,10,138,normal
90,24,8,20,142,normal
106,19,10,17,152,normal
96,7,6,4,113,normal
102,21,42,3,168,heavy
140,35,50,0,225,heavy
105,33,29,4,171,heavy
134,26,27,1,188,heavy
123,35,45,1,204,heavy
128,31,26,0,185,heavy
105,32,43,0,180,heavy
137,13,31,5,186,heavy
148,37,46,2,233,heavy
105,14,35,2,156,high
148,17,42,5,212,heavy
116,22,30,3,171,heavy
143,28,46,1,218,heavy
30,24,13,13,80,normal
74,23,35,10,142,high
67,5,36,17,125,high
59,11,33,25,128,high
34,21,39,16,110,normal
72,24,10,9,115,normal
73,12,32,5,122,high
26,8,8,24,66,normal
47,5,7,28,87,normal
33,10,6,29,78,normal
39,8,13,20,80,normal
36,5,14,22,77,normal
53,9,15,25,102,normal
37,9,10,30,86,normal
54,8,4,27,93,normal
20,8,15,26,69,normal
47,29,28,9,113,high
51,27,10,20,108,normal
114,11,40,20,185,heavy
73,13,19,9,114,normal
28,19,27,5,79,normal
105,20,20,11,156,normal
68,24,15,14,121,normal
112,16,30,11,169,heavy
120,30,28,15,193,heavy
38,27,12,18,95,normal
94,17,14,15,140,normal
107,28,45,8,188,heavy
100,16,49,7,172,heavy
145,15,20,9,189,heavy
133,17,22,8,180,heavy
117,36,41,10,204,heavy
113,26,26,8,173,heavy
101,20,21,9,151,normal
149,33,45,10,237,heavy
134,35,26,7,202,heavy
106,11,45,9,171,heavy
121,37,34,6,198,heavy
97,13,11,15,136,normal
91,17,18,29,155,high
57,16,13,19,105,normal
110,10,10,20,150,normal
71,14,17,30,132,high
89,25,20,24,158,high
87,16,15,14,132,normal
106,12,16,9,143,normal
78,10,19,20,127,normal
61,10,16,27,114,high
74,19,15,24,132,high
56,20,11,25,112,high
106,22,16,18,162,normal
10,1,1,12,24,low
12,4,1,33,50,normal
16,4,0,16,36,normal
18,1,0,18,37,normal
19,2,0,36,57,normal
18,4,1,35,58,normal
17,0,0,31,48,normal
18,1,0,16,35,normal
15,4,0,37,56,normal
11,5,0,14,30,normal
11,5,0,22,38,normal
12,2,1,37,52,normal
18,1,1,34,54,normal
19,1,0,11,31,low
11,4,1,26,42,normal
18,3,0,28,49,normal
12,4,1,37,54,normal
11,1,1,29,42,normal
19,5,1,29,54,normal
18,4,0,11,33,low
16,4,0,29,49,normal
19,4,1,33,57,normal
15,3,1,12,31,low
16,4,1,28,49,normal
11,4,0,20,35,normal
93,4,1,16,114,normal
114,12,7,18,151,normal
56,7,5,20,88,normal
92,23,3,19,137,normal
99,6,6,7,118,normal
108,14,6,9,137,normal
66,20,2,16,104,normal
147,26,44,5,222,heavy
139,27,29,1,196,heavy
119,31,36,5,191,heavy
114,30,21,2,167,normal
103,27,21,4,155,normal
105,17,29,4,155,high
124,29,41,1,195,heavy
118,19,34,1,172,heavy
101,37,32,0,170,heavy
109,11,48,1,169,heavy
143,12,23,3,181,heavy
143,40,30,0,213,heavy
128,16,34,0,178,heavy
14,25,14,16,69,normal
99,10,11,15,135,normal
67,1,22,14,104,normal
42,2,29,9,82,normal
92,3,33,21,149,high
91,16,28,9,144,high
25,9,10,28,72,normal
37,5,12,29,83,normal
55,6,12,29,102,normal
49,8,8,26,91,normal
69,9,3,20,101,normal
38,6,6,24,74,normal
40,8,12,21,81,normal
53,5,3,20,81,normal
21,8,4,28,61,normal
24,7,4,20,55,normal
47,24,24,9,104,normal
90,30,32,8,160,high
120,21,22,14,177,heavy
120,12,40,13,185,heavy
66,14,21,7,108,normal
89,24,12,6,131,normal
80,17,16,5,118,normal
114,21,10,9,154,normal
94,20,7,10,131,normal
70,18,28,5,121,high
56,17,15,8,96,low
141,15,20,6,182,heavy
150,19,46,7,222,heavy
119,37,22,8,186,heavy
144,14,44,5,207,heavy
110,25,46,6,187,heavy
138,15,31,10,194,heavy
140,35,41,5,221,heavy
103,24,28,8,163,high
142,27,30,5,204,heavy
149,13,22,9,193,heavy
126,40,39,8,213,heavy
78,15,14,28,135,high
102,15,11,29,157,high
96,22,20,12,150,normal
110,24,15,14,163,normal
97,22,17,13,149,normal
53,19,11,18,101,normal
82,8,17,29,136,high
91,24,18,29,162,high
102,6,14,35,157,high
109,6,15,18,148,normal
78,16,13,27,134,high
66,12,16,33,127,high
100,17,15,22,154,high
15,1,1,25,42,normal
16,1,0,33,50,normal
19,4,0,26,49,normal
10,0,1,34,45,normal
14,0,0,28,42,normal
13,2,0,22,37,normal
18,5,1,20,44,normal
18,4,0,18,40,normal
11,3,0,26,40,normal
13,1,0,24,38,normal
19,5,1,15,40,normal
11,3,1,28,43,normal
11,1,1,40,53,normal
18,4,1,28,51,normal
15,2,1,16,34,normal
20,0,0,27,47,normal
14,5,0,17,36,normal
11,3,1,10,25,low
18,5,0,22,45,normal
12,4,0,16,32,normal
10,2,0,24,36,normal
20,0,1,36,57,normal
20,1,0,29,50,normal
16,4,0,24,44,normal
18,3,0,22,43,normal
88,11,10,3,112,normal
114,5,9,7,135,normal
103,3,9,17,132,normal
81,16,7,14,118,normal
94,1,9,3,107,low
56,11,9,15,91,normal
80,16,5,10,111,low
138,35,47,4,224,heavy
123,27,22,4,176,heavy
114,30,36,2,182,heavy
122,30,37,2,191,heavy
148,10,28,2,188,heavy
127,38,48,0,213,heavy
113,32,44,1,190,heavy
131,26,40,1,198,heavy
108,27,44,5,184,heavy
109,19,49,3,180,heavy
125,15,28,3,171,heavy
139,30,35,4,208,heavy
103,35,50,2,190,heavy
64,13,40,12,129,high
79,1,10,30,120,high
50,2,7,14,73,normal
84,18,18,28,148,high
99,16,39,26,180,heavy
42,3,27,18,90,normal
53,2,29,24,108,normal
63,10,8,28,109,normal
24,8,3,20,55,normal
46,8,6,26,86,normal
20,7,8,26,61,normal
41,8,7,27,83,normal
44,5,3,28,80,normal
33,6,14,28,81,normal
30,9,7,25,71,normal
68,7,5,25,105,normal
28,29,26,5,88,normal
96,20,14,18,148,normal
24,15,26,13,78,normal
70,21,32,18,141,high
49,21,11,20,101,normal
51,22,12,16,101,normal
84,12,15,15,126,normal
99,18,7,20,144,normal
106,10,9,8,133,normal
6,11,34,20,71,normal
59,29,15,16,119,normal
139,25,41,5,210,heavy
109,12,49,6,176,heavy
124,24,47,9,204,heavy
135,29,39,7,210,heavy
137,15,37,7,196,heavy
119,28,46,9,202,heavy
127,21,28,5,181,heavy
109,37,44,9,199,heavy
145,27,35,7,214,heavy
133,36,28,6,203,heavy
138,19,36,5,198,heavy
73,5,20,10,108,normal
83,11,14,33,141,high
89,8,10,19,126,normal
99,19,18,24,160,high
54,17,14,8,93,low
58,18,14,6,96,low
56,16,12,9,93,low
77,6,20,5,108,normal
85,6,18,17,126,normal
105,14,13,32,164,high
96,21,11,24,152,high
66,22,17,16,121,normal
88,15,19,14,136,normal
16,1,1,24,42,normal
13,1,0,11,25,low
13,5,1,23,42,normal
19,5,0,37,61,normal
19,1,0,31,51,normal
11,5,0,19,35,normal
18,3,0,32,53,normal
17,1,1,38,57,normal
17,3,0,20,40,normal
18,4,1,19,42,normal
19,3,0,24,46,normal
16,3,0,15,34,normal
12,5,1,21,39,normal
17,3,0,36,56,normal
19,4,1,21,45,normal
13,5,0,20,38,normal
14,0,1,37,52,normal
14,5,0,39,58,normal
13,1,0,19,33,normal
18,5,1,25,49,normal
15,1,1,15,32,normal
19,2,0,30,51,normal
18,2,1,27,48,normal
13,1,0,38,52,normal
19,2,0,32,53,normal
116,0,1,9,126,normal
60,12,8,15,95,normal
82,15,0,19,116,normal
67,23,7,3,100,low
59,27,10,18,114,normal
66,6,9,5,86,low
120,10,3,16,149,normal
121,22,30,0,173,heavy
130,27,39,5,201,heavy
139,31,44,3,217,heavy
129,14,43,5,191,heavy
131,28,43,5,207,heavy
119,39,24,1,183,heavy
142,25,34,5,206,heavy
123,22,22,3,170,heavy
106,19,38,4,167,normal
115,39,20,2,176,heavy
111,17,32,1,161,high
144,26,50,3,223,normal
126,31,48,2,207,heavy
73,22,21,29,145,high
28,7,25,18,78,normal
31,10,40,9,90,normal
51,14,33,14,112,high
22,7,39,23,91,normal
46,5,11,21,83,normal
72,22,21,27,142,high
70,5,5,29,109,normal
28,9,9,24,70,normal
44,5,11,23,83,normal
27,6,13,30,76,normal
20,6,6,23,55,normal
29,7,3,28,67,normal
20,6,5,27,58,normal
65,9,15,22,111,normal
36,5,6,20,67,normal
99,21,21,6,147,normal
101,21,34,18,174,heavy
98,29,34,12,173,heavy
113,20,7,13,153,normal
75,24,27,7,133,high
71,21,38,11,141,high
119,13,32,7,171,heavy
114,11,39,13,177,heavy
99,26,8,11,144,normal
39,12,21,9,81,normal
114,26,16,20,176,heavy
120,32,39,9,200,heavy
143,24,35,6,208,heavy
121,28,21,5,175,heavy
134,23,28,10,195,heavy
103,13,37,10,163,high
122,12,48,10,192,heavy
145,39,23,6,213,heavy
105,13,48,10,176,heavy
144,13,40,10,207,heavy
103,18,40,5,166,high
120,15,34,8,177,heavy
56,19,16,13,104,normal
56,5,17,14,92,normal
108,15,13,5,141,normal
58,23,14,34,129,high
58,13,11,33,115,high
76,24,14,15,129,normal
69,8,13,28,118,high
54,9,12,10,85,low
89,7,10,10,116,normal
110,18,18,10,156,normal
86,12,17,18,133,normal
82,7,16,9,114,normal
102,5,19,11,137,normal
16,5,0,21,42,normal
11,3,1,39,54,normal
18,5,0,11,34,low
12,0,1,32,45,normal
15,4,1,39,59,normal
15,4,0,26,45,normal
13,1,0,30,44,normal
12,3,0,28,43,normal
17,2,1,20,40,normal
14,5,1,33,53,normal
16,3,1,11,31,low
18,2,1,13,34,normal
12,2,1,17,32,normal
17,4,1,15,37,normal
18,1,1,25,45,normal
20,1,1,10,32,low
15,1,0,21,37,normal
11,3,1,34,49,normal
19,0,1,13,33,normal
10,3,0,14,27,normal
17,5,1,17,40,normal
16,1,0,11,28,low
11,0,1,33,45,normal
10,5,0,39,54,normal
12,3,0,32,47,normal
106,16,10,10,142,normal
69,18,0,12,99,low
103,26,6,12,147,normal
99,25,6,6,136,normal
85,9,4,11,109,low
109,0,3,8,120,normal
106,27,1,6,140,normal
133,28,31,3,195,heavy
108,39,34,5,186,heavy
101,12,48,1,162,high
145,11,29,1,186,heavy
112,33,29,3,177,heavy
111,18,32,4,165,high
133,39,44,2,218,heavy
115,34,37,5,191,heavy
135,35,38,3,211,heavy
142,40,28,3,213,heavy
124,11,27,2,164,high
122,29,31,5,187,heavy
101,19,23,5,148,normal
72,5,15,20,112,normal
100,13,23,9,145,normal
32,10,33,8,83,normal
42,25,37,12,116,high
81,25,40,20,166,high
56,18,9,23,106,normal
84,9,31,17,141,high
36,9,8,28,81,normal
32,5,11,27,75,normal
26,7,15,27,75,normal
34,5,5,22,66,normal
66,9,6,30,111,normal
69,10,4,24,107,normal
44,7,9,20,80,normal
58,10,5,27,100,normal
27,6,14,30,77,normal
19,21,25,15,80,normal
39,15,30,8,92,normal
109,21,10,12,152,normal
93,10,9,15,127,normal
73,16,12,11,112,normal
111,18,29,16,174,heavy
37,20,10,19,86,normal
74,23,13,20,130,normal
32,28,35,6,101,normal
34,23,19,17,93,normal
59,25,9,20,113,normal
145,12,24,8,189,heavy
118,17,28,8,171,heavy
145,20,47,8,220,heavy
140,25,46,10,221,heavy
120,35,43,7,205,heavy
126,24,31,7,188,heavy
106,22,43,5,176,heavy
137,40,28,9,214,heavy
108,40,25,6,179,heavy
135,15,50,6,206,heavy
121,21,49,8,199,heavy
59,6,20,6,91,normal
59,13,18,27,117,high
103,7,15,15,140,normal
56,14,14,31,115,high
106,23,12,9,150,normal
109,5,16,17,147,normal
110,5,20,11,146,normal
86,15,15,23,139,high
91,18,19,26,154,high
99,19,15,28,161,high
93,14,20,17,144,normal
89,25,13,23,150,high
107,15,12,24,158,high
16,5,0,14,35,normal
14,5,1,20,40,normal
18,3,0,24,45,normal
12,3,0,40,55,normal
14,4,1,27,46,normal
18,5,1,15,39,normal
10,4,1,23,38,normal
10,5,0,14,29,normal
14,3,0,28,45,normal
10,2,0,38,50,normal
19,0,0,32,51,normal
20,3,0,19,42,normal
18,3,0,14,35,normal
11,2,0,12,25,low
17,1,1,13,32,normal
10,0,1,36,47,normal
17,0,0,32,49,normal
20,5,1,22,48,normal
12,3,0,17,32,normal
13,0,0,31,44,normal
11,1,1,35,48,normal
18,2,0,19,39,normal
15,0,1,24,40,normal
14,3,0,25,42,normal
12,0,1,16,29,normal
85,24,5,5,119,normal
71,22,5,2,100,low
108,4,5,3,120,normal
63,29,5,15,112,normal
62,12,3,18,95,normal
118,15,3,11,147,normal
90,21,2,14,127,normal
141,30,31,1,203,heavy
126,31,33,2,192,heavy
112,26,30,4,172,heavy
112,12,38,4,166,high
144,14,33,4,195,heavy
127,13,36,1,177,heavy
146,10,44,5,205,heavy
146,22,26,4,198,heavy
101,10,48,5,164,high
104,19,24,4,151,normal
150,20,43,0,213,heavy
110,35,45,2,192,heavy
139,15,28,2,184,heavy
99,17,32,7,155,high
22,15,7,19,63,normal
11,12,21,24,68,normal
47,20,18,16,101,normal
54,1,35,26,116,high
26,16,13,16,71,normal
99,18,39,19,175,heavy
31,9,11,28,79,normal
24,8,13,23,68,normal
21,7,9,20,57,normal
60,10,5,25,100,normal
29,9,12,21,71,normal
37,7,14,28,86,normal
53,7,11,22,93,normal
35,5,15,25,80,normal
53,6,10,28,97,normal
114,18,17,8,157,normal
95,28,22,9,154,normal
62,23,38,19,142,high
70,28,12,12,122,normal
35,20,10,8,73,low
60,23,10,20,113,normal
40,22,25,9,96,normal
53,21,6,11,91,low
99,16,38,7,160,high
86,21,31,18,156,high
79,28,35,13,155,high
146,25,33,8,212,heavy
116,24,36,6,182,heavy
107,14,44,5,170,heavy
115,20,27,9,171,heavy
113,23,43,6,185,heavy
102,20,31,5,158,high
138,27,21,7,193,heavy
146,13,38,9,206,heavy
139,33,41,7,220,heavy
130,24,48,9,211,heavy
135,31,34,8,208,heavy
106,22,16,20,164,normal
109,23,14,26,172,heavy
108,24,19,10,161,normal
50,16,16,11,93,normal
102,22,17,10,151,normal
72,25,10,27,134,high
91,13,18,13,135,normal
67,19,11,8,105,low
61,14,10,5,90,low
107,13,14,28,162,high
91,5,12,34,142,high
106,18,13,27,164,high
107,14,10,18,149,normal
17,4,1,20,42,normal
11,4,1,30,46,normal
11,4,0,23,38,normal
16,3,1,36,56,normal
11,0,1,30,42,normal
15,4,1,25,45,normal
16,5,0,27,48,normal
14,3,1,15,33,normal
